.............
...BBBBBBB...
.............
.............
.............
......F......
.............