............R
..R.......S..
.......H.....
.....C.......
..........L..
...R...H..R..
.....M.......