.............
..WA..H...F..
......R......
....RRRRR....
......R......
..F..H..WA...
.............