............#
..#.......S..
.......@.....
.....C..#....
.............
...#...@..#..
.....!......C