@@@.......@@@
@...........@
...#..Z..#...
...#.ZZZ.#...
...#..Z..#...
@...........@
@@@.......@@@