HHH.......HHH
H...........H
...R.....R...
...R.....R...
...R.....R...
H...........H
HHH.......HHH