.........#...
.W...W...#...
...@@@@@@@...
......W......
...@@@@@@@...
...#.........
...#......W..