.........#.W.
.W.......#...
...@@@@@@@...
......W......
...@@@@@@@...
...#.........
...#......W..