.........R...
.........R...
...HHHHHHH...
.............
...HHHHHHH...
...R.........
...R.........