.........R...
........SR...
...HHHHHHH...
.....AAA.....
...HHHHHHH...
...RP........
...R.........