SRR..........
P.RR.........
...RR........
WWW.RR.....AA
.....RR......
......RR.....
.......AAAAAA