S##..........
..##.....F.F.
...##........
....##.......
.....##......
..FF..##.....
............S