S##..........
..##.......F.
...##........
....##.F.....
.....##......
..F...##.....
............S