.RR..........
..RR.........
...RR........
....RR.......
.....RR......
......RR.....
.............