.............
......M......
....W@@@W....
....@@@@@....
....W@@@W....
......M......
.............