.............
......M......
....M@@@W....
....@@@@@....
....W@@@M....
......M......
.............