.............
.............
RRR...HHHHHHH
.............
HHHHHHH...RRR
.............
.............