.............
.W.......N...
###...@@@@@@@
......M......
@@@@@@@...###
..N........W.
.............