.............
.M.......N...
###...@@@@@@@
......W......
@@@@@@@...###
..N........M.
.............