.....C......#
..#..........
.............
.............
...####...#..
..F####.F.#..
.............