.WW.........P
..........HHR
.............
...RHH.......
...RRHHH.....
...ASRRH.....
..........WW.