.....C......R
..R..........
.............
.F...........
...RRRR...L..
...RRRR...R..
.F...........