#.C.........#
..........S..
....@@@@.....
....@@@@..S..
....@@@@.....
..........#..
.Z...$.......