.....C......R
..R.......S..
....HHHH.....
.F..HHHH.....
....HHHH..L..
...R...H..R..
.F...M.......