.....C......#
..#.......S..
.............
....FF.......
.......F.....
...######.#..
.....$.......