.............
...HH...HH...
...HRAAARH...
....R.S.R....
....R.P.R....
....RRRRR....
....W.W.W....