.....C......R
..R.......S..
.............
.FFFFF.......
..........L..
...RRRRRR.R..
.F...M.......