.....C......R
..R.......S..
.......H.....
.F...C.......
...MMMMMMML..
...MMMMMM.R..
.F...M.......