.............
....HHHHH....
....R...R....
...AAAAAAA...
....R...R....
....HHHHH....
.............