.............
....#...#....
....#$?$#....
....@@@@@....
....@SSS@....
....@###@....
.............