............
.RR...H...RR.
.WW...H...WW.
......H......
.WW...H...WW.
.RR...H...RR.
.............