.............
.RR...H...RR.
......H......
......H......
......H......
.RR...H...RR.
.............