..S.@.......N
...#@........
..##@........
.............
........@##..
........@#...
N.......@.S..