....H........
...RH........
..RRH........
.............
........HRR..
........HR...
........H....