....H........
..SRH........
..RRH..AAAA..
.............
.WWWW...HRR..
........HRP...
........H....