HH.......AAAA
HH...........
........PR...
...RRRRRRR...
...RS........
...........HH
AAAA.......HH