@@...........
@@...........
......M..#...
...#######...
...#..M......
...........@@
.M.......F.@@