@@...........
@@...........
......M..#...
...#######...
...#.........
......M....@@
.M.......F.@@