HH...........
HH...........
.........R...
...RRRRRRR...
...R.........
...........HH
...........HH