.............
..##..F..##..
...@..N..@...
...@..N..@...
...@..N..@...
..##..F..##..
.............