.............
..RR.WWW.RR..
...H..S..H...
...H..P..H...
...H..S..H...
..RR.WWW.RR..
.............