.............
..RR.....RR..
...H.....H...
...H.....H...
...H.....H...
..RR.....RR..
.............