............R
..R..........
.......H.....
.............
.............
...R...H..R..
.E...........