.....C......R
..R.......S..
.......H.....
.F...C.......
..........L..
...R...H..R..
.F...M.......