.....C......R
..R..........
.......H.....
.F...C.......
.............
...R...H..R..
.F...........